R 720 480
NO ./texture/wood.xpm
SO ./texture/redbrick.xpm
WE ./texture/stone.xpm
EA ./texture/mossy.xpm
S ./texture/barrel.xpm
F 35,51,117
C 0,0,0

11111111111111111111111111111
10000000001100002200000000001
10110000011100002220000010001
10010000000000002200000010001
10110000011100000000000010101
10000000001100000111011110011
11110111111111011100000010001
11110111111111011101010010101
11000000110101011100000010011
10000000000000001100000010001
10000000000000001101010010N01
11000000110101011111011110001
11110111111101011111011110001
11111111111111111111111111111
