R 1920	1080
NO ./texture/wood.xpm
SO ./texture/redbrick.xpm
WE ./texture/stone.xpm
EA ./texture/mossy.xpm
S ./texture/barrel.xpm
F 35,51,117
C 0,0,0

111111111111111111111111
100000000000000000000001
100E00000000000000000001
100000000000000000000001
100000111110000101010001
100000100010000000000001
100000100010000100010001
100000100010000000000001
100000110110000101010001
100000000000000000000001
100000000000000000000001
100000000002000000000001
100000000000000000000001
100000000000000000000001
100000000000100000000001
100000000000000000000001
111111111000000000000001
110100001000000000000001
110000101000000000000001
110100001000000000000001
110111111000000000000001
110000000000000000000001
111111111000000000000001
111111111111111111111111
